10 10 10 10 10 10 10 10 10 10 10 10 10 10 10 10 76 70 70 70 70 70 70 70 70 70 70 70 70 70 70 70 77 10 10 10 10 10 10 10 10 10 10 10 10 10 10 10 10 10
10 10 10 10 10 10 10 10 10 10 10 10 10 10 10 10 76 70 70 70 70 70 70 70 70 70 70 70 70 70 73 75 80 10 10 10 10 10 10 10 10 10 10 10 10 10 10 10 10 10
10 10 10 10 10 10 10 10 10 10 10 10 10 10 10 10 82 75 75 75 75 75 71 70 70 73 75 75 75 75 80 10 10 10 10 10 10 10 10 10 10 10 10 10 10 10 10 10 10 10
10 10 10 10 10 10 10 10 10 10 10 10 10 10 10 10 10 10 10 10 10 10 76 70 70 77 10 10 10 10 10 10 10 10 10 10 10 10 10 10 10 10 10 10 10 10 10 10 10 10
10 10 10 10 10 10 10 10 10 10 10 10 10 10 10 10 10 10 10 10 10 10 76 70 70 77 10 10 10 10 10 10 10 10 10 10 10 10 10 10 10 10 10 10 10 10 10 10 10 10
10 10 10 10 10 10 10 10 10 10 10 10 10 10 10 10 10 10 10 10 81 78 72 70 70 77 10 10 10 10 10 10 10 10 10 10 10 10 10 10 10 10 10 10 10 10 10 10 10 10
10 10 10 10 10 10 10 10 10 10 10 10 10 10 10 10 10 10 10 10 82 75 75 75 75 80 10 10 10 10 10 10 10 10 10 10 10 10 10 10 10 10 10 10 10 10 10 10 10 10
10 10 10 10 10 10 10 10 10 10 10 10 10 10 10 10 10 10 10 10 12 21 21 21 21 15 10 10 10 10 10 10 10 10 10 10 10 10 10 10 10 10 10 10 10 10 10 10 10 10
10 10 10 10 10 10 10 10 10 10 10 10 10 10 10 10 10 10 10 10 14 20 17 11 11 23 10 10 10 10 10 10 10 10 10 10 10 10 10 10 10 10 10 10 10 10 10 10 10 10
10 10 10 10 10 10 10 10 10 10 10 10 10 10 10 10 10 10 10 10 10 10 14 17 11 18 15 10 10 10 10 10 10 10 10 10 10 10 10 10 10 10 10 10 10 10 10 10 10 10
10 10 10 10 10 10 10 10 10 10 10 10 10 10 10 10 10 10 10 10 10 10 10 22 11 16 13 10 10 10 10 10 10 10 10 10 10 10 10 10 10 10 10 10 10 10 10 10 10 10
10 10 10 10 10 10 10 10 10 10 10 10 10 10 10 10 10 10 10 10 10 10 10 22 11 23 10 10 10 10 10 10 10 10 10 10 10 10 10 10 10 10 10 10 10 10 10 10 10 10
10 10 10 10 10 10 10 10 10 10 10 10 10 10 10 10 10 10 10 10 10 10 10 22 11 23 10 10 10 10 10 10 10 10 10 10 10 10 10 10 10 10 10 10 10 10 10 10 10 10
10 10 10 10 10 10 10 10 10 10 10 10 10 10 10 10 10 10 10 10 10 10 12 19 11 23 10 10 10 10 10 10 10 10 10 10 10 10 10 10 10 10 10 10 10 10 10 10 10 10
10 10 10 10 10 10 10 10 10 10 10 10 10 10 10 10 10 10 10 10 10 12 19 11 16 13 10 10 10 10 10 10 10 10 10 10 10 10 10 10 10 10 10 10 10 10 10 10 10 10
10 10 10 10 10 10 10 10 10 10 10 10 10 10 10 10 10 10 10 10 12 19 11 11 23 10 10 10 10 10 10 10 10 10 10 10 10 10 10 10 10 10 10 10 10 10 10 10 10 10
10 10 10 10 10 10 10 10 10 10 10 10 10 10 10 10 10 10 10 12 19 11 11 11 23 10 10 10 10 10 10 10 10 10 10 10 10 10 10 10 10 10 10 10 10 10 10 10 10 10
10 10 10 10 10 10 10 10 10 10 10 10 10 10 10 10 10 10 10 22 11 11 11 11 18 15 10 10 10 10 10 10 10 10 10 10 10 10 10 10 10 10 10 10 10 10 10 10 10 10
10 10 10 10 10 10 10 10 10 10 10 10 10 10 10 10 10 12 21 19 11 11 11 11 11 23 10 10 10 10 10 10 10 10 10 10 10 10 10 10 10 10 10 10 10 10 10 10 10 10
10 10 10 10 10 10 10 10 10 10 10 10 10 10 10 10 10 22 11 11 11 11 11 11 11 23 10 10 10 10 10 10 10 10 10 10 10 10 10 10 10 10 10 10 10 10 10 10 10 10
42 42 10 10 10 10 10 10 10 10 10 10 10 10 10 10 12 19 11 11 11 11 11 11 11 18 21 21 15 10 10 10 10 10 10 10 12 21 15 10 10 10 10 10 10 10 10 10 32 39
42 42 10 10 10 10 10 10 10 10 10 10 10 10 10 10 22 11 11 11 11 11 11 11 11 11 11 11 23 10 10 10 10 10 10 12 19 11 23 10 10 10 10 10 10 10 10 10 38 30
42 42 10 10 10 42 12 15 10 10 10 10 10 10 12 21 19 11 11 11 11 11 11 11 11 11 11 11 23 10 10 10 10 10 10 22 11 11 18 15 10 10 10 10 10 10 10 10 38 30
42 42 10 10 10 42 22 23 10 10 10 10 10 10 14 17 11 11 11 11 11 11 11 11 11 11 11 11 18 15 10 10 10 12 21 19 11 11 11 23 10 10 10 10 10 10 10 10 38 30
42 42 10 10 10 42 22 18 15 10 10 10 10 10 10 22 11 11 11 11 11 11 11 11 11 11 11 11 11 23 10 10 10 22 11 11 16 20 17 18 15 10 10 10 10 10 10 10 38 30
42 42 10 10 42 42 22 11 18 21 21 21 21 21 21 19 11 11 11 11 11 11 11 11 11 11 11 11 11 18 21 21 21 19 11 11 23 10 22 11 23 10 10 10 10 10 10 10 38 30
42 42 42 42 42 42 22 11 11 11 11 11 11 11 11 11 11 11 11 11 11 11 11 11 11 11 11 11 11 11 11 11 11 11 16 20 13 10 22 11 18 15 10 10 10 10 32 39 34 30
42 42 42 42 42 42 14 17 11 11 16 20 20 17 11 11 11 11 11 11 11 11 11 11 11 11 11 11 11 11 16 20 20 20 13 10 10 10 22 11 16 13 10 10 32 39 34 30 30 30
42 42 42 42 42 42 10 14 20 20 13 10 10 14 17 11 11 11 11 11 11 11 11 11 11 11 11 11 11 11 23 10 10 10 10 10 10 10 14 17 23 32 39 39 34 30 30 30 30 30
42 42 42 42 42 10 10 10 10 10 10 10 10 10 22 11 11 11 11 11 11 11 11 11 11 11 11 11 11 11 23 10 10 10 10 10 10 10 10 22 23 38 30 30 35 37 37 40 30 30
42 42 10 10 10 10 10 10 10 10 10 10 10 10 22 11 11 11 11 11 11 11 11 11 11 11 11 11 11 11 23 10 10 10 10 10 10 10 10 22 23 38 30 35 31 10 10 38 30 30
42 42 10 10 10 10 10 10 10 10 10 10 10 10 14 17 11 11 11 11 11 11 11 11 11 11 11 11 11 11 23 10 10 10 10 10 10 10 10 14 13 33 37 31 10 10 10 33 40 30
42 42 10 10 10 10 10 10 10 10 10 10 10 10 10 22 11 11 11 11 11 11 11 11 11 16 20 20 20 20 13 10 10 10 10 10 10 10 10 10 10 10 10 10 10 10 10 10 38 30
42 42 10 10 10 10 10 10 10 10 10 10 10 10 10 14 17 11 11 11 11 11 11 11 11 23 10 10 10 10 10 10 10 10 10 10 10 10 10 10 10 10 10 10 10 10 10 10 33 37
42 42 10 10 10 10 10 10 10 10 10 10 10 27 25 26 14 17 11 11 11 11 11 16 20 13 10 10 10 10 10 10 10 10 10 10 10 10 10 10 10 10 10 10 10 10 10 10 10 10
10 10 10 10 10 10 10 10 10 10 10 10 10 41 24 28 26 22 11 11 11 11 11 23 10 10 10 10 10 10 10 10 10 10 10 10 10 10 10 10 10 10 10 10 10 10 10 10 10 10
10 10 10 10 10 10 10 10 10 10 10 10 10 41 24 24 29 14 20 20 17 11 11 23 10 10 10 10 10 10 10 10 10 10 10 10 10 10 10 10 10 10 10 10 10 10 10 10 10 10
10 10 10 10 10 10 10 10 10 10 10 10 10 41 24 24 28 25 25 26 14 17 11 23 10 10 10 10 10 10 10 10 10 10 10 10 10 10 10 10 10 10 10 10 10 10 10 10 10 10
10 10 10 10 10 10 10 10 10 10 10 10 10 41 24 24 24 24 24 28 26 22 11 18 15 10 10 10 10 10 10 10 10 10 10 10 10 10 10 10 10 10 10 10 10 10 10 10 10 10
10 10 10 10 10 10 10 10 10 10 10 10 10 41 24 24 24 24 24 24 29 22 11 11 23 10 10 10 10 10 10 10 10 10 10 10 10 10 10 10 10 10 10 10 10 10 10 10 10 10
10 10 10 10 10 10 10 10 10 10 10 10 10 10 10 10 10 10 10 10 12 19 11 11 23 10 10 10 10 10 10 10 10 10 10 10 10 10 10 10 10 10 10 10 10 10 10 10 10 10
10 10 10 10 10 10 10 10 10 10 10 10 10 10 10 10 10 10 10 10 22 11 11 11 18 21 21 15 10 10 10 10 10 10 10 10 10 10 10 10 10 10 10 10 10 10 10 10 10 10
10 10 10 10 10 10 10 10 10 10 10 10 10 10 10 10 10 10 10 10 14 20 20 20 20 20 20 13 10 10 10 10 10 10 10 10 10 10 10 10 10 10 10 10 10 10 10 10 10 10
10 10 10 10 10 10 10 10 10 10 10 10 10 10 10 10 10 10 10 10 53 61 61 61 61 61 61 51 10 10 10 10 10 10 10 10 10 10 10 10 10 10 10 10 10 10 10 10 10 10
10 10 10 10 10 10 10 10 10 10 10 10 10 10 10 10 10 10 10 10 60 50 50 50 50 50 50 62 10 10 10 10 10 10 10 10 10 10 10 10 10 10 10 10 10 10 10 10 10 10
10 10 10 10 10 10 10 10 10 10 10 10 10 10 10 10 10 10 10 10 54 55 50 50 50 50 50 62 10 10 10 10 10 10 10 10 10 10 10 10 10 10 10 10 10 10 10 10 10 10
10 10 10 10 10 10 10 10 10 10 10 10 10 10 10 10 10 10 10 10 10 60 50 50 50 57 59 52 10 10 10 10 10 10 10 10 10 10 10 10 10 10 10 10 10 10 10 10 10 10
10 10 10 10 10 10 10 10 10 10 10 10 10 10 10 53 61 61 61 61 61 56 50 50 50 62 10 10 10 10 10 10 10 10 10 10 10 10 10 10 10 10 10 10 10 10 10 10 10 10
10 10 10 10 10 10 10 10 10 10 10 10 10 10 10 60 50 50 50 50 50 50 50 50 50 58 61 61 61 61 61 61 61 51 10 10 10 10 10 10 10 10 10 10 10 10 10 10 10 10
10 10 10 10 10 10 10 10 10 10 10 10 10 10 10 60 50 50 50 50 50 50 50 50 50 50 50 50 50 50 50 50 50 62 10 10 10 10 10 10 10 10 10 10 10 10 10 10 10 10