10 10 10 10 10 10 10 10 10 10 10 10 10 10 10 10 22 11 11 11 11 11 11 11 11 11 11 11 11 11 11 11 23 10 10 10 10 10 10 10 10 10 10 10 10 10 10 10 10 10
10 10 10 10 10 10 10 10 10 10 10 10 10 10 10 10 22 11 11 11 11 11 11 11 11 11 11 11 11 11 16 20 13 10 10 10 10 10 10 10 10 10 10 10 10 10 10 10 10 10
10 10 10 10 10 10 10 10 10 10 10 10 10 10 10 10 14 20 20 20 20 20 17 11 11 16 20 20 20 20 13 10 10 10 10 10 10 10 10 10 10 10 10 10 10 10 10 10 10 10
10 10 10 10 10 10 10 10 10 10 10 10 10 10 10 10 10 10 10 10 10 10 22 11 11 23 10 10 10 10 10 10 10 10 10 10 10 10 10 10 10 10 10 10 10 10 10 10 10 10
10 10 10 10 10 10 10 10 10 10 10 10 10 10 10 10 10 10 10 10 10 10 22 11 11 23 10 10 10 10 10 10 10 10 10 10 10 10 10 10 10 10 10 10 10 10 10 10 10 10
10 10 10 10 10 10 10 10 10 10 10 10 10 10 10 10 10 10 10 10 12 21 19 11 11 23 10 10 10 10 10 10 10 10 10 10 10 10 10 10 10 10 10 10 10 10 10 10 10 10
10 10 10 10 10 10 10 10 10 10 10 10 10 10 10 10 10 10 10 10 22 11 11 11 11 23 10 10 10 10 10 10 10 10 10 10 10 10 10 10 10 10 10 10 10 10 10 10 10 10
10 10 10 10 10 10 10 10 10 10 10 10 10 10 10 10 10 10 10 10 12 21 21 21 21 15 10 10 10 10 10 10 10 10 10 10 10 10 10 10 10 10 10 10 10 10 10 10 10 10
10 10 10 10 10 10 10 10 10 10 10 10 10 10 10 10 10 10 10 10 14 20 17 11 11 23 10 10 10 10 10 10 10 10 10 10 10 10 10 10 10 10 10 10 10 10 10 10 10 10
10 10 10 10 10 10 10 10 10 10 10 10 10 10 10 10 10 10 10 10 10 10 14 17 11 18 15 10 10 10 10 10 10 10 10 10 10 10 10 10 10 10 10 10 10 10 10 10 10 10
10 10 10 10 10 10 10 10 10 10 10 10 10 10 10 10 10 10 10 10 10 10 10 22 11 16 13 10 10 10 10 10 10 10 10 10 10 10 10 10 10 10 10 10 10 10 10 10 10 10
10 10 10 10 10 10 10 10 10 10 10 10 10 10 10 10 10 10 10 10 10 10 10 22 11 23 10 10 10 10 10 10 10 10 10 10 10 10 10 10 10 10 10 10 10 10 10 10 10 10
10 10 10 10 10 10 10 10 10 10 10 10 10 10 10 10 10 10 10 10 10 10 10 22 11 23 10 10 10 10 10 10 10 10 10 10 10 10 10 10 10 10 10 10 10 10 10 10 10 10
10 10 10 10 10 10 10 10 10 10 10 10 10 10 10 10 10 10 10 10 10 10 12 19 11 23 10 10 10 10 10 10 10 10 10 10 10 10 10 10 10 10 10 10 10 10 10 10 10 10
10 10 10 10 10 10 10 10 10 10 10 10 10 10 10 10 10 10 10 10 10 12 19 11 16 13 10 10 10 10 10 10 10 10 10 10 10 10 10 10 10 10 10 10 10 10 10 10 10 10
10 10 10 10 10 10 10 10 10 10 10 10 10 10 10 10 10 10 10 10 12 19 11 11 23 10 10 10 10 10 10 10 10 10 10 10 10 10 10 10 10 10 10 10 10 10 10 10 10 10
10 10 10 10 10 10 10 10 10 10 10 10 10 10 10 10 10 10 10 12 19 11 11 11 23 10 10 10 10 10 10 10 10 10 10 10 10 10 10 10 10 10 10 10 10 10 10 10 10 10
10 10 10 10 10 10 10 10 10 10 10 10 10 10 10 10 10 10 10 22 11 11 11 11 18 15 10 10 10 10 10 10 10 10 10 10 10 10 10 10 10 10 10 10 10 10 10 10 10 10
10 10 10 10 10 10 10 10 10 10 10 10 10 10 10 10 10 12 21 19 11 11 11 11 11 23 10 10 10 10 10 10 10 10 10 10 10 10 10 10 10 10 10 10 10 10 10 10 10 10
10 10 10 10 10 10 10 10 10 10 10 10 10 10 10 10 10 22 11 11 11 11 11 11 11 23 10 10 10 10 10 10 10 10 10 10 10 10 10 10 10 10 10 10 10 10 10 10 10 10
21 15 10 10 10 10 10 10 10 10 10 10 10 10 10 10 12 19 11 11 11 11 11 11 11 18 21 21 15 10 10 10 10 10 10 10 12 21 15 10 10 10 10 10 10 10 10 10 32 39
11 23 10 10 10 10 10 10 10 10 10 10 10 10 10 10 22 11 11 11 11 11 11 11 11 11 11 11 23 10 10 10 10 10 10 12 19 11 23 10 10 10 10 10 10 10 10 10 38 30
11 23 10 10 10 12 12 15 10 10 10 10 10 10 12 21 19 11 11 11 11 11 11 11 11 11 11 11 23 10 10 10 10 10 10 22 11 11 18 15 10 10 10 10 10 10 10 10 38 30
11 23 10 10 10 22 22 23 10 10 10 10 10 10 14 17 11 11 11 11 11 11 11 11 11 11 11 11 18 15 10 10 10 12 21 19 11 11 11 23 10 10 10 10 10 10 10 10 38 30
11 23 10 10 10 22 22 18 15 10 10 10 10 10 10 22 11 11 11 11 11 11 11 11 11 11 11 11 11 23 10 10 10 22 11 11 16 20 17 18 15 10 10 10 10 10 10 10 38 30
11 23 10 10 12 19 22 11 18 21 21 21 21 21 21 19 11 11 11 11 11 11 11 11 11 11 11 11 11 18 21 21 21 19 11 11 23 10 22 11 23 10 10 10 10 10 10 10 38 30
11 18 21 21 19 11 22 11 11 11 11 11 11 11 11 11 11 11 11 11 11 11 11 11 11 11 11 11 11 11 11 11 11 11 16 20 13 10 22 11 18 15 10 10 10 10 32 39 34 30
11 11 11 11 11 16 14 17 11 11 16 20 20 17 11 11 11 11 11 11 11 11 11 11 11 11 11 11 11 11 16 20 20 20 13 10 10 10 22 11 16 13 10 10 32 39 34 30 30 30
11 11 11 11 16 13 10 14 20 20 13 10 10 14 17 11 11 11 11 11 11 11 11 11 11 11 11 11 11 11 23 10 10 10 10 10 10 10 14 17 23 32 39 39 34 30 30 30 30 30
11 16 20 20 13 10 10 10 10 10 10 10 10 10 22 11 11 11 11 11 11 11 11 11 11 11 11 11 11 11 23 10 10 10 10 10 10 10 10 22 23 38 30 30 35 37 37 40 30 30
11 23 10 10 10 10 10 10 10 10 10 10 10 10 22 11 11 11 11 11 11 11 11 11 11 11 11 11 11 11 23 10 10 10 10 10 10 10 10 22 23 38 30 35 31 10 10 38 30 30
11 23 10 10 10 10 10 10 10 10 10 10 10 10 14 17 11 11 11 11 11 11 11 11 11 11 11 11 11 11 23 10 10 10 10 10 10 10 10 14 13 33 37 31 10 10 10 33 40 30
11 23 10 10 10 10 10 10 10 10 10 10 10 10 10 22 11 11 11 11 11 11 11 11 11 16 20 20 20 20 13 10 10 10 10 10 10 10 10 10 10 10 10 10 10 10 10 10 38 30
11 23 10 10 10 10 10 10 10 10 10 10 10 10 10 14 17 11 11 11 11 11 11 11 11 23 10 10 10 10 10 10 10 10 10 10 10 10 10 10 10 10 10 10 10 10 10 10 33 37
20 13 10 10 10 10 10 10 10 10 10 10 10 10 10 10 14 17 11 11 11 11 11 16 20 13 10 10 10 10 10 10 10 10 10 10 10 10 10 10 10 10 10 10 10 10 10 10 10 10
10 10 10 10 10 10 10 10 10 10 10 10 10 10 10 10 10 22 11 11 11 11 11 23 10 10 10 10 10 10 10 10 10 10 10 10 10 10 10 10 10 10 10 10 10 10 10 10 10 10
10 10 10 10 10 10 10 10 10 10 10 10 10 10 10 10 10 14 20 17 11 11 11 23 10 10 10 10 10 10 10 10 10 10 10 10 10 10 10 10 10 10 10 10 10 10 10 10 10 10
10 10 10 10 10 10 10 10 10 10 10 10 10 10 10 10 10 10 10 14 17 11 11 23 10 10 10 10 10 10 10 10 10 10 10 10 10 10 10 10 10 10 10 10 10 10 10 10 10 10
10 10 10 10 10 10 10 10 10 10 10 10 10 10 10 10 10 10 10 10 14 17 11 18 15 10 10 10 10 10 10 10 10 10 10 10 10 10 10 10 10 10 10 10 10 10 10 10 10 10
10 10 10 10 10 10 10 10 10 10 10 10 10 10 10 10 10 10 10 10 10 22 11 11 23 10 10 10 10 10 10 10 10 10 10 10 10 10 10 10 10 10 10 10 10 10 10 10 10 10
10 10 10 10 10 10 10 10 10 10 10 10 10 10 10 10 10 10 10 10 12 19 11 11 23 10 10 10 10 10 10 10 10 10 10 10 10 10 10 10 10 10 10 10 10 10 10 10 10 10
10 10 10 10 10 10 10 10 10 10 10 10 10 10 10 10 10 10 10 10 22 11 11 11 18 21 21 15 10 10 10 10 10 10 10 10 10 10 10 10 10 10 10 10 10 10 10 10 10 10
10 10 10 10 10 10 10 10 10 10 10 10 10 10 10 10 10 10 10 10 14 20 20 20 20 20 20 13 10 10 10 10 10 10 10 10 10 10 10 10 10 10 10 10 10 10 10 10 10 10
10 10 10 10 10 10 10 10 10 10 10 10 10 10 10 10 10 10 10 10 53 61 61 61 61 61 61 51 10 10 10 10 10 10 10 10 10 10 10 10 10 10 10 10 10 10 10 10 10 10
10 10 10 10 10 10 10 10 10 10 10 10 10 10 10 10 10 10 10 10 60 50 50 50 50 50 50 62 10 10 10 10 10 10 10 10 10 10 10 10 10 10 10 10 10 10 10 10 10 10
10 10 10 10 10 10 10 10 10 10 10 10 10 10 10 10 10 10 10 10 54 55 50 50 50 50 50 62 10 10 10 10 10 10 10 10 10 10 10 10 10 10 10 10 10 10 10 10 10 10
10 10 10 10 10 10 10 10 10 10 10 10 10 10 10 10 10 10 10 10 10 60 50 50 50 57 59 52 10 10 10 10 10 10 10 10 10 10 10 10 10 10 10 10 10 10 10 10 10 10
10 10 10 10 10 10 10 10 10 10 10 10 10 10 10 53 61 61 61 61 61 56 50 50 50 62 10 10 10 10 10 10 10 10 10 10 10 10 10 10 10 10 10 10 10 10 10 10 10 10
10 10 10 10 10 10 10 10 10 10 10 10 10 10 10 60 50 50 50 50 50 50 50 50 50 58 61 61 61 61 61 61 61 51 10 10 10 10 10 10 10 10 10 10 10 10 10 10 10 10
10 10 10 10 10 10 10 10 10 10 10 10 10 10 10 60 50 50 50 50 50 50 50 50 50 50 50 50 50 50 50 50 50 62 10 10 10 10 10 10 10 10 10 10 10 10 10 10 10 10