10 10 10 10 10 10 10 10 10 10 10 10 10 10 10 10 22 11 11 11 11 11 11 11 11 11 11 11 11 11 11 11 23 10 10 10 10 10 10 10 10 10 10 10 10 10 10 10 10 10
10 10 10 10 10 10 10 10 10 10 10 10 10 10 10 10 22 11 11 11 11 11 11 11 11 11 11 11 11 11 16 20 13 10 10 10 10 10 10 10 10 10 10 10 10 10 10 10 10 10
10 10 10 10 10 10 10 10 10 10 10 10 10 10 10 10 14 20 20 20 20 20 17 11 11 16 20 20 20 20 13 10 10 10 10 10 10 10 10 10 10 10 10 10 10 10 10 10 10 10
10 10 10 10 10 10 10 10 10 10 10 10 10 10 10 10 10 10 10 10 10 10 22 11 11 23 10 10 10 10 10 10 10 10 10 10 10 10 10 10 10 10 10 10 10 10 10 10 10 10
10 10 10 10 10 10 10 10 10 10 10 10 10 10 10 10 10 10 10 10 10 10 22 11 11 23 10 10 10 10 10 10 10 10 10 10 10 10 10 10 10 10 10 10 10 10 10 10 10 10
10 10 10 10 10 10 10 10 10 10 10 10 10 10 10 10 10 10 10 10 12 21 19 11 11 23 10 10 10 10 10 10 10 10 10 10 10 10 10 10 10 10 10 10 10 10 10 10 10 10
10 10 10 10 10 10 10 10 10 10 10 10 10 10 10 10 10 10 10 10 22 11 11 11 11 23 10 10 10 10 10 10 10 10 10 10 10 10 10 10 10 10 10 10 10 10 10 10 10 10
10 10 10 10 10 10 10 10 10 10 10 10 10 10 10 10 10 10 10 10 22 11 11 11 11 23 10 10 10 10 10 10 10 10 10 10 10 10 10 10 10 10 10 10 10 10 10 10 10 10
10 10 10 10 10 10 10 10 10 10 10 10 10 10 10 10 10 10 10 10 14 20 17 11 11 23 10 10 10 10 10 10 10 10 10 10 10 10 10 10 10 10 10 10 10 10 10 10 10 10
10 10 10 10 10 10 10 10 10 10 10 10 10 10 10 10 10 10 10 10 10 10 14 17 11 18 15 10 10 10 10 10 10 10 10 10 10 10 10 10 10 10 10 10 10 10 10 10 10 10
10 10 10 10 10 10 10 10 10 10 10 10 10 10 10 10 10 10 10 10 10 10 10 22 11 16 13 10 10 10 10 10 10 10 10 10 10 10 10 10 10 10 10 10 10 10 10 10 10 10
10 10 10 10 10 10 10 10 10 10 10 10 10 10 10 10 10 10 10 10 10 10 10 22 11 23 10 10 10 10 10 10 10 10 10 10 10 10 10 10 10 10 10 10 10 10 10 10 10 10
10 10 10 10 10 10 10 10 10 10 10 10 10 10 10 10 10 10 10 10 10 10 10 22 11 23 10 10 10 10 10 10 10 10 10 10 10 10 10 10 10 10 10 10 10 10 10 10 10 10
10 10 10 10 10 10 10 10 10 10 10 10 10 10 10 10 10 10 10 10 10 10 12 19 11 23 10 10 10 10 10 10 10 10 10 10 10 10 10 10 10 10 10 10 10 10 10 10 10 10
10 10 10 10 10 10 10 10 10 10 10 10 10 10 10 10 10 10 10 10 10 12 19 11 16 13 10 10 10 10 10 10 10 10 10 10 10 10 10 10 10 10 10 10 10 10 10 10 10 10
10 10 10 10 10 10 10 10 10 10 10 10 10 10 10 10 10 10 10 10 12 19 11 11 23 10 10 10 10 10 10 10 10 10 10 10 10 10 10 10 10 10 10 10 10 10 10 10 10 10
10 10 10 10 10 10 10 10 10 10 10 10 10 10 10 10 10 10 10 12 19 11 11 11 23 10 10 10 10 10 10 10 10 10 10 10 10 10 10 10 10 10 10 10 10 10 10 10 10 10
10 10 10 10 10 10 10 10 10 10 10 10 10 10 10 10 10 10 10 22 11 11 11 11 18 15 10 10 10 10 10 10 10 10 10 10 10 10 10 10 10 10 10 10 10 10 10 10 10 10
10 10 10 10 10 10 10 10 10 10 10 10 10 10 10 10 10 12 21 19 11 11 11 11 11 23 10 10 10 10 10 10 10 10 10 10 10 10 10 10 10 10 10 10 10 10 10 10 10 10
10 10 10 10 10 10 10 10 10 10 10 10 10 10 10 10 10 22 11 11 11 11 11 11 11 23 10 10 10 10 10 10 10 10 10 10 10 10 10 10 10 10 10 10 10 10 10 10 10 10
21 15 10 10 10 10 10 10 10 10 10 10 10 10 10 10 12 19 11 11 11 11 11 11 11 18 21 21 15 10 10 10 10 10 10 10 12 21 15 10 10 10 10 10 10 10 10 10 12 21
11 23 10 10 10 10 10 10 10 10 10 10 10 10 10 10 22 11 11 11 11 11 11 11 11 11 11 11 23 10 10 10 10 10 10 12 19 11 23 10 10 10 10 10 10 10 10 12 19 11
11 23 10 10 10 12 21 15 10 10 10 10 10 10 12 21 19 11 11 11 11 11 11 11 11 11 11 11 23 10 10 10 10 10 10 22 11 11 18 15 10 10 10 10 10 10 10 22 11 11
11 23 10 10 10 22 11 23 10 10 10 10 10 10 14 17 11 11 11 11 11 11 11 11 11 11 11 11 18 15 10 10 10 12 21 19 11 11 11 23 10 10 10 10 10 10 10 14 17 11
11 23 10 10 10 22 11 18 15 10 10 10 10 10 10 22 11 11 11 11 11 11 11 11 11 11 11 11 11 23 10 10 10 22 11 11 16 20 17 18 15 10 10 10 10 10 10 10 22 11
11 23 10 10 12 19 11 11 18 21 21 21 21 21 21 19 11 11 11 11 11 11 11 11 11 11 11 11 11 18 21 21 21 19 11 11 23 10 22 11 23 10 10 10 10 10 10 10 22 11
11 18 21 21 19 11 11 11 11 11 11 11 11 11 11 11 11 11 11 11 11 11 11 11 11 11 11 11 11 11 11 11 11 11 16 20 13 10 22 11 18 15 10 10 10 10 12 21 19 11
11 11 11 11 11 16 20 17 11 11 16 20 20 17 11 11 11 11 11 11 11 11 11 11 11 11 11 11 11 11 16 20 20 20 13 10 10 10 22 11 11 23 10 10 12 21 19 11 11 11
11 11 11 11 16 13 10 14 20 20 13 10 10 14 17 11 11 11 11 11 11 11 11 11 11 11 11 11 11 11 23 10 10 10 10 10 10 10 14 17 11 18 21 21 19 11 11 11 11 11
11 16 20 20 13 10 10 10 10 10 10 10 10 10 22 11 11 11 11 11 11 11 11 11 11 11 11 11 11 11 23 10 10 10 10 10 10 10 10 22 11 11 11 11 16 20 20 17 11 11
11 23 10 10 10 10 10 10 10 10 10 10 10 10 22 11 11 11 11 11 11 11 11 11 11 11 11 11 11 11 23 10 10 10 10 10 10 10 10 22 11 11 11 16 13 10 10 22 11 11
11 23 10 10 10 10 10 10 10 10 10 10 10 10 14 17 11 11 11 11 11 11 11 11 11 11 11 11 11 11 23 10 10 10 10 10 10 10 10 14 20 20 20 13 10 10 10 14 17 11
11 23 10 10 10 10 10 10 10 10 10 10 10 10 10 22 11 11 11 11 11 11 11 11 11 16 20 20 20 20 13 10 10 10 10 10 10 10 10 10 10 10 10 10 10 10 10 10 22 11
11 23 10 10 10 10 10 10 10 10 10 10 10 10 10 14 17 11 11 11 11 11 11 11 11 23 10 10 10 10 10 10 10 10 10 10 10 10 10 10 10 10 10 10 10 10 10 10 14 20
20 13 10 10 10 10 10 10 10 10 10 10 10 10 10 10 14 17 11 11 11 11 11 16 20 13 10 10 10 10 10 10 10 10 10 10 10 10 10 10 10 10 10 10 10 10 10 10 10 10
10 10 10 10 10 10 10 10 10 10 10 10 10 10 10 10 10 22 11 11 11 11 11 23 10 10 10 10 10 10 10 10 10 10 10 10 10 10 10 10 10 10 10 10 10 10 10 10 10 10
10 10 10 10 10 10 10 10 10 10 10 10 10 10 10 10 10 14 20 17 11 11 11 23 10 10 10 10 10 10 10 10 10 10 10 10 10 10 10 10 10 10 10 10 10 10 10 10 10 10
10 10 10 10 10 10 10 10 10 10 10 10 10 10 10 10 10 10 10 14 17 11 11 23 10 10 10 10 10 10 10 10 10 10 10 10 10 10 10 10 10 10 10 10 10 10 10 10 10 10
10 10 10 10 10 10 10 10 10 10 10 10 10 10 10 10 10 10 10 10 14 17 11 18 15 10 10 10 10 10 10 10 10 10 10 10 10 10 10 10 10 10 10 10 10 10 10 10 10 10
10 10 10 10 10 10 10 10 10 10 10 10 10 10 10 10 10 10 10 10 10 22 11 11 23 10 10 10 10 10 10 10 10 10 10 10 10 10 10 10 10 10 10 10 10 10 10 10 10 10
10 10 10 10 10 10 10 10 10 10 10 10 10 10 10 10 10 10 10 10 12 19 11 11 23 10 10 10 10 10 10 10 10 10 10 10 10 10 10 10 10 10 10 10 10 10 10 10 10 10
10 10 10 10 10 10 10 10 10 10 10 10 10 10 10 10 10 10 10 10 22 11 11 11 18 21 21 15 10 10 10 10 10 10 10 10 10 10 10 10 10 10 10 10 10 10 10 10 10 10
10 10 10 10 10 10 10 10 10 10 10 10 10 10 10 10 10 10 10 10 22 11 11 11 11 11 11 23 10 10 10 10 10 10 10 10 10 10 10 10 10 10 10 10 10 10 10 10 10 10
10 10 10 10 10 10 10 10 10 10 10 10 10 10 10 10 10 10 10 10 22 11 11 11 11 11 11 23 10 10 10 10 10 10 10 10 10 10 10 10 10 10 10 10 10 10 10 10 10 10
10 10 10 10 10 10 10 10 10 10 10 10 10 10 10 10 10 10 10 10 22 11 11 11 11 11 11 23 10 10 10 10 10 10 10 10 10 10 10 10 10 10 10 10 10 10 10 10 10 10
10 10 10 10 10 10 10 10 10 10 10 10 10 10 10 10 10 10 10 10 14 17 11 11 11 11 11 23 10 10 10 10 10 10 10 10 10 10 10 10 10 10 10 10 10 10 10 10 10 10
10 10 10 10 10 10 10 10 10 10 10 10 10 10 10 10 10 10 10 10 10 22 11 11 11 16 20 13 10 10 10 10 10 10 10 10 10 10 10 10 10 10 10 10 10 10 10 10 10 10
10 10 10 10 10 10 10 10 10 10 10 10 10 10 10 12 21 21 21 21 21 19 11 11 11 23 10 10 10 10 10 10 10 10 10 10 10 10 10 10 10 10 10 10 10 10 10 10 10 10
10 10 10 10 10 10 10 10 10 10 10 10 10 10 10 22 11 11 11 11 11 11 11 11 11 18 21 21 21 21 21 21 21 15 10 10 10 10 10 10 10 10 10 10 10 10 10 10 10 10
10 10 10 10 10 10 10 10 10 10 10 10 10 10 10 22 11 11 11 11 11 11 11 11 11 11 11 11 11 11 11 11 11 23 10 10 10 10 10 10 10 10 10 10 10 10 10 10 10 10