0 0 0 0 0 1 1 1 1 1 1 0 0 0 0 0
0 0 0 0 0 1 1 0 0 1 1 0 0 0 0 0
1 1 1 1 1 0 2 8 9 2 0 1 1 1 1 1 
1 1 1 1 1 4 0 0 0 0 5 1 1 1 1 1 
1 1 0 2 2 8 0 0 0 0 9 2 2 0 1 1
1 1 0 3 3 6 0 0 0 0 7 3 3 0 1 1
1 1 1 1 1 4 0 0 0 0 5 1 1 1 1 1 
1 1 1 1 1 0 3 6 7 3 0 1 1 1 1 1 
0 0 0 0 0 1 1 4 5 1 1 0 0 0 0 0
0 0 0 0 0 1 1 0 0 1 1 0 0 0 0 0
0 0 0 0 0 1 1 1 1 1 1 0 0 0 0 0
0 0 0 0 0 1 1 1 1 1 1 0 0 0 0 0